%%%%%%%%%%%%%%%%%%%%%%%%%%%%
%.....       ..       .....%
%%%%%%...    ..    ...%%%%%%
%%%%%%%%%    ..    %%%%%%%%%
%..........  ..  ..........%
%%%%%%%%%%%  ..  %%%%%%%%%%%
%.           ..           .%
%%%%%%%%%%%%%..%%%%%%%%%%%%%
%.           ..           .%
%%%%%%%%%%%  ..  %%%%%%%%%%%
%.PP         ..           .%
%%%%%%%%%    ..    %%%%%%%%%
%.        %%%..%%%        .%
%%%%%%    %%GGGG%%    %%%%%%
%.        %%%%%%%%        .%
%%%%%%%%%....      %%%%%%%%%
%............             .%
%%%%%%%%%%%..    %%%%%%%%%%%
%............             .%
%%%%%%%%%%%%%  %%%%%%%%%%%%%
%..........................%
%..%%%%%%%%%%%%%%%%%%%%%%%%%
%..%..%..%..%..%..%..%..% o%
%                          %
%%%%%%%%%%%%%%%%%%%%%%%%%%%%
