%%%%%%%%%%%%%%%%%%%%
%o....o%GGGG%o....o%
%..%...%%  %%...%..%
%.%o.%........%.o%.%
%.o%.%.%%%%%%.%.%o.%
%ooo..o..P...o..ooo%
%%%%%%%%%%%%%%%%%%%%
